42x15
0,0,0,0,0,0,0,0,0,0,0,0,0,0,0,0,0,0,0,0,0,0,0,0,0,0,0,0,0,0,0,0,0,0,0,0,0,0,0,0,0,0,
0,1,1,1,1,1,1,1,1,1,1,1,1,1,1,1,1,1,1,1,1,1,1,1,1,1,1,1,1,1,1,1,1,1,1,1,1,1,1,1,1,0,
0,1,2,1,2,1,2,2,1,2,1,2,1,2,2,2,1,1,1,2,1,1,1,2,1,2,2,2,1,2,2,1,1,2,1,2,2,1,1,2,1,0,
0,1,2,1,2,1,2,1,1,2,1,2,1,2,1,2,1,1,1,2,1,1,1,2,1,2,1,2,1,2,1,2,1,2,1,2,1,2,1,2,1,0,
0,1,2,2,2,1,2,2,1,2,1,2,1,2,1,2,1,1,1,2,1,2,1,2,1,2,1,2,1,2,1,2,1,2,1,2,1,2,1,2,1,0,
0,1,2,1,2,1,2,1,1,2,1,2,1,2,1,2,1,1,1,2,1,2,1,2,1,2,1,2,1,2,2,1,1,2,1,2,1,2,1,1,1,0,
0,1,2,1,2,1,2,2,1,2,1,2,1,2,2,2,1,1,1,1,2,1,2,1,1,2,2,2,1,2,1,2,1,2,1,2,2,1,1,2,1,0,
0,1,1,1,1,8,1,1,1,1,1,1,1,1,1,1,1,1,1,1,1,1,1,1,1,1,1,1,1,1,1,1,1,1,1,1,1,1,1,1,1,0,
0,1,0,0,1,2,2,1,3,3,1,4,4,1,5,5,1,6,6,1,7,7,1,8,7,1,9,9,1,0,0,1,2,2,1,3,3,1,4,4,1,0,
0,1,0,0,1,2,2,1,3,3,1,4,4,1,5,5,1,6,6,1,7,7,1,7,7,1,9,9,1,0,0,1,2,2,1,3,3,1,4,4,1,0,
0,1,1,1,1,1,1,1,1,1,1,1,1,1,1,1,1,1,1,1,1,1,1,1,1,1,1,1,1,1,1,1,1,1,1,1,1,1,1,1,1,0,
0,1,5,5,1,6,6,1,7,7,1,7,7,1,9,9,1,0,0,1,2,2,1,3,3,1,4,4,1,5,5,1,6,6,1,7,7,1,7,7,1,0,
0,1,5,5,1,6,6,1,7,7,1,7,7,1,9,9,1,0,0,1,2,2,1,3,3,1,4,4,1,5,5,1,6,6,1,7,7,1,7,7,1,0,
0,1,1,1,1,1,1,1,1,1,1,1,1,1,1,1,1,1,1,1,1,1,1,1,1,1,1,1,1,1,1,1,1,1,1,1,1,1,1,1,1,0,
0,0,0,0,0,0,0,0,0,0,0,0,0,0,0,0,0,0,0,0,0,0,0,0,0,0,0,0,0,0,0,0,0,0,0,0,0,0,0,0,0,0,
Hello, World
What is the meaning of life?
