20x20
1,1,1,1,1,1,1,1,1,1,1,1,1,1,1,1,1,1,1,1,
1,4,4,4,4,4,4,4,4,4,4,4,4,4,4,4,4,4,4,1,
1,4,4,4,4,4,4,4,4,4,4,4,4,4,4,4,4,4,4,1,
1,4,4,1,1,1,1,1,1,4,4,1,1,1,1,1,1,4,4,1,
1,4,4,1,7,7,7,7,1,4,4,1,7,7,7,7,1,4,4,1,
1,4,4,1,7,7,7,7,1,4,4,1,7,7,7,7,1,4,4,1,
1,4,4,1,7,7,1,1,1,4,4,1,1,1,7,7,1,4,4,1,
1,4,4,1,7,7,1,4,4,4,4,4,4,1,7,7,1,4,4,1,
1,4,4,1,7,7,1,4,9,4,4,9,4,1,7,7,1,4,4,1,
1,4,4,1,7,7,1,4,4,4,4,4,4,1,7,7,1,4,4,1,
1,4,4,1,7,7,1,4,4,4,4,4,4,1,7,7,1,4,4,1,
1,4,4,1,7,7,1,4,9,4,4,9,4,1,7,7,1,4,4,1,
1,4,4,1,7,7,1,4,4,4,4,4,4,1,7,7,1,4,4,1,
1,4,4,1,7,7,1,1,1,1,1,1,1,1,7,7,1,4,4,1,
1,4,4,1,7,7,7,7,7,7,7,7,7,7,7,7,1,4,4,1,
1,4,4,1,7,7,7,7,7,7,7,7,7,7,7,7,1,4,4,1,
1,4,4,1,1,1,1,1,1,1,1,1,1,1,1,1,1,4,4,1,
1,4,4,4,4,4,4,4,4,4,4,4,4,4,4,4,4,4,4,1,
1,4,4,4,4,4,4,4,4,4,4,4,4,4,4,4,4,4,4,1,
1,1,1,1,1,1,1,1,1,1,1,1,1,1,1,1,1,1,1,1,
Welcome to my game!
The controls are WASD
meow
I'm a sign!!
