8x10
0,0,0,0,0,0,0,0,
0,1,1,1,1,1,1,0,
0,1,1,1,1,1,1,0,
0,1,1,1,1,1,1,0,
0,1,1,8,1,1,1,0,
0,1,1,1,1,1,1,0,
0,1,1,1,1,1,1,0,
0,1,1,1,1,1,1,0,
0,1,1,1,1,1,1,0,
0,0,0,0,0,0,0,0,
I'm a sign!
